C 25,23,150
F 1,1,1


EA textures/fire.xpm
NO textures/fire.xpm
WE textures/fire2.xpm
SO textures/fire2.xpm

1111
10N1
1111
