NO textures/no.xpm

EA textures/ea.xpm

SO textures/so.xpm

WE textures/we.xpm

C 35,19,167

F 0,150,0

111111111111111
111111000111111
111110000011111
111100000001111
111000000000111
1100000E0000011
100001111100001
110000111000011
111000010000111
111100000001111
111110111011111
1111111 1011111
1111111 1111111
