NO textures/fire.xpm
EA textures/fire.xpm
SO textures/fire2.xpm
WE textures/fire2.xpm

C 35,19,150

F 155,103,60

111111111111111
111111000111111
111110000011111
111100000001111
111000000000111
1100000E0000011
100001111100001
110000111000011
111000010000111
111100000001111
11111000001 111
11111101011 111
1111111 111 111
