C 25,23,150
F 1,1,1

EA textures/fire.xpm
NO textures/fire.xpm
WE textures/fire2.xpm
SO textures/fire2.xpm


111111111111111
111111000111111
111110000011111
111100000001111
111000000000111
1100000N0000011
100001111100001
110000111000011
111111111111111
111111111111111
111000010000111
111100000001111
11111000001 111
11111101011 111
1111111 111 111
11111111
1
1
1
1
111111111
